Afghan: afghani
African: african
Arabian: arabian
Argentine: argentine
Armenian: armenian
Asian Fusion: asianfusion
Australian: australian
Austrian: austrian
Bangladeshi: bangladeshi
Basque: basque
Barbeque: bbq
Belgian: belgian
Brasseries: brasseries
Brazilian: brazilian
Breakfast & Brunch: breakfast_brunch
British: british
Buffets: buffets
Burgers: burgers
Burmese: burmese
Cafes: cafes
Cafeteria: cafeteria
Cajun/Creole: cajun
Cambodian: cambodian
Caribbean: caribbean
Catalan: catalan
Cheesesteaks: cheesesteaks
Chicken Wings: chicken_wings
Chicken Shop: chickenshop
Chinese: chinese
Comfort Food: comfortfood
Creperies: creperies
Cuban: cuban
Czech: czech
Delis: delis
Diners: diners
Dinner Theater: dinnertheater
Ethiopian: ethiopian
Filipino: filipino
Fish & Chips: fishnchips
Fondue: fondue
Food Court: food_court
Food Stands: foodstands
French: french
Gastropubs: gastropubs
German: german
Gluten-Free: gluten_free
Greek: greek
Halal: halal
Hawaiian: hawaiian
Himalayan/Nepalese: himalayan
Hong Kong Style Cafe: hkcafe
Hot Dogs: hotdog
Fast Food: hotdogs
Hot Pot: hotpot
Hungarian: hungarian
Iberian: iberian
Indonesian: indonesian
Indian: indpak
Irish: irish
Italian: italian
Japanese: japanese
Korean: korean
Kosher: kosher
Laotian: laotian
Latin American: latin
Malaysian: malaysian
Mediterranean: mediterranean
Mexican: mexican
Middle Eastern: mideastern
Modern European: modern_european
Mongolian: mongolian
Moroccan: moroccan
American (New): newamerican
New Mexican Cuisine: newmexican
Nicaraguan: nicaraguan
Noodles: noodles
Pakistani: pakistani
Persian/Iranian: persian
Peruvian: peruvian
Pizza: pizza
Polish: polish
Pop-Up Restaurants: popuprestaurants
Portuguese: portuguese
Poutineries: poutineries
Live/Raw Food: raw_food
Russian: russian
Salad: salad
Sandwiches: sandwiches
Scandinavian: scandinavian
Scottish: scottish
Seafood: seafood
Singaporean: singaporean
Slovakian: slovakian
Soul Food: soulfood
Soup: soup
Southern: southern
Spanish: spanish
Sri Lankan: srilankan
Steakhouses: steak
Supper Clubs: supperclubs
Sushi Bars: sushi
Syrian: syrian
Taiwanese: taiwanese
Tapas Bars: tapas
Tapas/Small Plates: tapasmallplates
Tex-Mex: tex-mex
Thai: thai
American (Traditional): tradamerican
Turkish: turkish
Ukrainian: ukrainian
Uzbek: uzbek
Vegan: vegan
Vegetarian: vegetarian
Vietnamese: vietnamese
Waffles: waffles
